╔═══════════════════════════════════════════════════════════════════════════════════════════════════╗
║                                                                                                   ║
║                                                                                                   ║
║                                                                                                   ║
║   @                                                                                               ║
║                                                                                                   ║
║                                                                                                   ║
║                                                                                                   ║
║                                                                                                   ║
║                                                                                                   ║
║                                                                                                   ║
║                                                                                                   ║
║                                                                                                   ║
║                                                                                                   ║
║                                                                                                   ║
║                                                                                                   ║
║                                                                                                   ║
║                                                                                                   ║
║                                                                                                   ║
║                                                                                                   ║
║                                                                                                   ║
║                                                                                                   ║
║                                                                                                   ║
║                                                                                                   ║
║                                                                                                   ║
║                                                                                                   ║
║                                                                                                   ║
║                                                                                                   ║
║                                                                                                   ║
║                                                                                                   ║
║                                                                                                   ║
║                                                                                                   ║
║                                                                                                   ║
║                                                                                                   ║
║                                                                                                   ║
╚═══════════════════════════════════════════════════════════════════════════════════════════════════╝
