╔═══════════════╦═══════════════════════════════════════════════════╗
║ @             ║                                                   ║
╠══════════════ ╠═════════╗ ╔════════                               ║
║                                                                   ║
║                                                                   ║
║                                                                   ║
║                                                                   ║
║                                                                   ║
║                                                                   ║
║                                                                   ║
║                                                                   ║
║                                                                   ║
║                                                                   ║
║                                                                   ║
║                                                                   ║
║                                                                   ║
║                                                                   ║
║                                                                   ║
║                                                                   ║
║                                                                   ║
║                                                                 s ║
╚═══════════════════════════════════════════════════════════════════╝