	    0	1	2	3	4	5	6	7	8	9	A	B	C	D	E	F
U+250x	─	━	│	┃	┄	┅	┆	┇	┈	┉	┊	┋	┌	┍	┎	┏
U+251x	┐	┑	┒	┓	└	┕	┖	┗	┘	┙	┚	┛	├	┝	┞	┟
U+252x	┠	┡	┢	┣	┤	┥	┦	┧	┨	┩	┪	┫	┬	┭	┮	┯
U+253x	┰	┱	┲	┳	┴	┵	┶	┷	┸	┹	┺	┻	┼	┽	┾	┿
U+254x	╀	╁	╂	╃	╄	╅	╆	╇	╈	╉	╊	╋	╌	╍	╎	╏
U+255x	═	║	╒	╓	╔	╕	╖	╗	╘	╙	╚	╛	╜	╝	╞	╟
U+256x	╠	╡	╢	╣	╤	╥	╦	╧	╨	╩	╪	╫	╬	╭	╮	╯
U+257x	╰	╱	╲	╳	╴	╵	╶	╷	╸	╹	╺	╻	╼	╽	╾	╿


╔═══════════════╦═══════════════════════════════════════════════════╗
║               ║                                                   ║
╠══════════════ ╠═════════╗ ╔════════                               ║
║                                                                   ║
║                                                                   ║
║                                                                   ║
║                                                                   ║
║                                                                   ║
║                                                                   ║
║                                                                   ║
║                                                                   ║
║                                                                   ║
║                                                                   ║
║                                                                   ║
║                                                                   ║
║                                                                   ║
║                                                                   ║
║                                                                   ║
║                                                                   ║
║                                                                   ║
║                                                                   ║
╚═══════════════════════════════════════════════════════════════════╝